20 20
5 3 4 4 4 4 4 4 4 4 4 4 4 4 4 4 4 4 4 3
5 2 0 0 0 0 0 0 0 0 0 0 0 0 0 0 0 0 0 3
5 2 0 0 0 0 0 0 0 0 0 1 0 1 0 1 1 1 0 3
5 2 0 1 1 1 0 1 0 1 1 1 1 1 0 1 0 1 0 3
5 2 0 0 0 0 0 0 0 0 0 0 0 0 0 1 0 1 0 3
5 2 1 1 1 1 0 0 1 1 1 1 1 1 1 1 0 1 0 3
5 2 0 0 0 0 0 0 0 0 0 0 0 0 0 0 0 0 0 3
5 2 0 0 1 1 1 1 1 1 0 0 1 1 1 1 1 1 0 3
5 2 0 0 1 0 0 0 0 0 0 0 1 0 0 0 0 0 0 3
5 2 0 0 1 0 1 1 1 1 0 0 1 0 1 1 1 1 1 3
5 2 1 1 1 0 1 0 0 0 0 0 0 0 0 0 0 0 0 3
5 2 0 0 0 0 1 0 0 0 0 1 0 0 0 0 1 0 0 3
5 2 1 1 1 1 1 0 0 0 0 1 0 0 0 0 1 0 0 3
5 2 0 0 0 0 1 1 1 1 0 1 1 1 1 1 1 0 0 3
5 2 0 0 0 0 0 0 0 0 0 1 1 0 0 0 0 0 0 3
5 2 0 1 1 1 0 1 1 1 1 1 1 0 1 1 1 1 0 3
5 2 0 0 0 1 0 1 0 0 0 0 0 0 0 0 1 0 0 3
5 2 0 1 0 0 0 0 0 1 1 1 1 1 1 0 1 0 0 3
5 2 0 1 0 0 0 0 0 0 0 0 0 0 0 0 0 0 0 3
5 2 3 3 3 3 3 3 3 3 3 3 3 3 3 3 3 3 3 3