20 20
6 6 6 6 6 6 6 6 6 6 6 6 6 6 6 6 6 6 6 6
6 8 8 8 8 8 8 8 8 9 8 8 8 8 8 8 8 8 8 6
6 8 8 8 9 9 9 8 9 9 8 8 9 9 8 9 9 9 8 6
6 8 8 8 8 9 8 8 8 8 8 8 9 8 8 8 9 8 8 6
6 9 9 9 9 9 8 8 8 8 8 8 9 8 8 8 9 8 8 6
6 8 8 8 8 9 8 8 8 8 8 8 9 9 9 9 9 8 8 6
6 8 9 9 8 9 9 9 8 8 8 9 9 9 9 9 9 8 8 6
6 8 9 8 8 8 8 9 9 9 9 9 9 8 8 8 8 8 8 6
6 8 9 8 8 9 8 9 8 8 8 9 9 8 8 9 9 9 8 6
6 9 9 9 9 9 8 9 9 9 8 9 9 8 8 9 8 8 8 6
6 8 8 8 8 9 8 8 8 8 8 8 8 8 8 9 9 9 8 6
6 8 9 9 8 8 8 9 9 9 9 9 9 9 8 8 9 8 8 6
6 8 8 9 8 9 8 8 8 8 8 8 9 8 8 8 8 8 8 6
6 8 8 9 8 9 9 9 9 8 8 8 9 8 8 8 8 9 8 6
6 8 8 9 8 9 8 8 9 9 8 8 9 8 8 9 9 9 8 6
6 8 8 9 8 9 8 8 8 8 8 8 8 8 8 8 8 9 8 6
6 9 9 9 8 8 8 8 8 8 8 9 9 8 8 9 8 9 8 6
6 8 8 8 8 8 9 9 9 9 9 9 8 8 8 9 8 9 8 6
6 8 8 8 8 8 9 8 8 8 8 8 8 8 8 9 8 8 8 6
6 6 6 6 6 6 6 6 6 6 6 6 6 6 6 6 6 6 6 6